10 10 1
9 1 1 1 1 1 5 9 1 5 
8 2 2 4 10 4 8 2 4 12 
12 9 1 2 1 4 8 1 4 14 
8 2 4 9 4 8 6 12 8 5 
8 3 2 2 4 8 7 8 4 14 
10 5 13 13 8 2 1 6 10 5 
13 8 4 8 2 3 2 1 3 4 
8 2 4 8 1 1 5 10 3 6 
12 9 4 8 2 4 8 1 1 5 
10 2 2 2 3 2 2 2 2 6 