10 10 1
9 7 9 1 7 9 3 3 3 7 
8 1 4 10 1 4 11 1 1 5 
8 4 8 1 4 10 1 4 8 4 
8 4 10 4 12 9 2 4 8 4 
14 8 1 4 8 4 9 6 8 6 
13 8 2 2 2 4 8 1 4 13 
12 8 1 1 1 2 2 4 8 4 
12 8 4 8 4 11 1 2 6 14 
12 10 2 4 8 1 2 7 9 5 
10 3 3 6 10 2 3 3 2 6 